You just woke up laying in soft sand. A bright hot sun is shining in your eyes. You do not know how you ended up here but it appears as if you were washed ashore somehow. What you do know however is that you need to get off the island quickly before you go insane. You are currently on a beach.

Get Off The Island
An Interactive Fiction by ggrune20
Release 1 / Serial number 190213 / Inform 7 build 6M62 (I6/v6.33 lib 6/12N) SD

Beach
The sun is bright at the beach. The sand is soft but scorching hot. Crystal blue waves crash on the sand surging up and down the shoreline. You see a steel box on the beach covered in sand. There is a jungle to the west.

>go west
Forest
The Forest is dense and full of bushes, trees, and other shrubbery. Vines hang down from the dark green trees. The ground is muddy and damp. You hear loud birds squacking as a light breeze blows past you.

You can see an Ancient Energy Staff here.

>pick up Ancient Energy Staff
Taken.

* * *

>go west
Forest
The Forest is dense and full of bushes, trees, and other shrubbery. Vines hang down from the dark green trees. The ground is muddy and damp. You hear loud birds squacking as a light breeze blows past you.

You can see an Ancient Energy Staff here.

>pick up energy staff
Taken.

>Helicopter
That's not a verb I recognise.

>Walk to Helicopter
You can't see any such thing.

>go est
You can't see any such thing.

>go east
Beach
The sun is bright at the beach. The sand is soft but scorching hot. Crystal blue waves crash on the shore surging up and down the shoreline.

>use key on The Steel Box
That's not a verb I recognise.

* * *

>inspect box
That's not a verb I recognise.

>view box
That's not a verb I recognise.

>look at box
A rusty mysterious box laying in the sand that is made out of steel. Maybe there is something inside. A heavy duty lock keeps it closed. You need something very powerful to break the lock and unlock the box with.

>unlock box
(with The Steel Box)
(first taking The Steel Box)
That's hardly portable.

>break lock
You can't see any such thing.

>west
Jungle
The Jungle is dense and full of bushes, trees, and other shrubbery. Vines hang down from the dark green trees. The ground is muddy and damp. You hear loud birds squacking in the distance as a light breeze blows past you. You see an old wooden shack at the base of the largest tree. The beach is to the east.

You can see an Ancient Energy Staff here.

>take staff
Taken.

>east
Beach
The sun is bright at the beach. The sand is soft but scorching hot. Crystal blue waves crash on the sand surging up and down the shoreline. You see a steel box on the beach covered in sand. There is a jungle to the west.

>break lock with staff
You can't see any such thing.

I beg your pardon?

>unlock box with staff
You point the energy staff towards the steel box and a blue beam of energy shoots out from the tip, breaking the lock off.

You unlock The Steel Box.

>eat staff
That's plainly inedible.

* * *

>north
beach
The sun is bright at the beach. The sand is soft and scorching hot. Crystal blue waves crash on the shore surging up and down the shoreline.

* * *

>pick up ancient staff
Taken.

>north
Beach
The sun is bright at the beach. The sand is soft but scorching hot. Crystal blue waves crash on the shore surging up and down the shoreline.

* * *

>s boc
I only understood you as far as wanting to (go) s.

>x box
A rusty mysterious box laying in the sand that is made out of steel. Maybe there is something inside. A heavy duty lock keeps it closed. You need something very powerful to break the lock and unlock the box with.

I beg your pardon?

I beg your pardon?

* * *

>steel box
That's not a verb I recognise.

>go west
Forest
The Forest is dense and full of bushes, trees, and other shrubbery. Vines hang down from the dark green trees. The ground is muddy and damp. You hear loud birds squacking as a light breeze blows past you.

You can see an Ancient Energy Staff here.

>pick up ancien energy staff
You can't see any such thing.

>pick up ancient energy staff
Taken.

>go east
Beach
The sun is bright at the beach. The sand is soft but scorching hot. Crystal blue waves crash on the shore surging up and down the shoreline.

>use ancient enrgy staff on steel box
That's not a verb I recognise.

>look for steel box
You can't see any such thing.

* * *

>west
Jungle
The Jungle is dense and full of bushes, trees, and other shrubbery. Vines hang down from the dark green trees. The ground is muddy and damp. You hear loud birds squacking in the distance as a light breeze blows past you. You see an old wooden shack at the base of the largest tree. The beach is to the east.

You can see an Ancient Energy Staff here.

>eat staff
You try eating the energy staff and when you put your face close to the blue energy orb a stream of energy blows off your head.

    *** You have lost. You are dead. ***

Would you like to RESTART, RESTORE a saved game, QUIT or UNDO the last command?

* * *

>west
Jungle
The Jungle is dense and full of bushes, trees, and other shrubbery. Vines hang down from the dark green trees. The ground is muddy and damp. You hear loud birds squacking in the distance as a light breeze blows past you. You see an old wooden shack at the base of the largest tree. The beach is to the east.

You can see an Ancient Energy Staff here.

>inspect
That's not a verb I recognise.

>look at staff
The staff is very majestic. It is made out of weathered down wood and appears to be centuries old. It may be old but the staff is also very heavy and sturdy. A blue energy orb is attached to the end of the staff. You have a feeling that a beam of energy can be shot from the energy orb.

>east
Beach
The sun is bright at the beach. The sand is soft but scorching hot. Crystal blue waves crash on the shore surging up and down the shoreline. You see a steel box on the beach. There is a jungle to the west.

>look at box
An rusty mysterious box laying in the sand that is made out of steel. Maybe there is something inside. A heavy duty lock keeps it closed. You need something very powerful to break the lock.

>Unlock box with staff
You can't see any such thing.

>Unlock The Steel Box with The Energy Staff
I only understood you as far as wanting to unlock The Steel Box with The Steel Box.

>West
Jungle
The Jungle is dense and full of bushes, trees, and other shrubbery. Vines hang down from the dark green trees. The ground is muddy and damp. You hear loud birds squacking in the distance as a light breeze blows past you. You see an old wooden shack at the base of the largest tree.

You can see an Ancient Energy Staff here.

>take staff
Taken.

>east
Beach
The sun is bright at the beach. The sand is soft but scorching hot. Crystal blue waves crash on the shore surging up and down the shoreline. You see a steel box on the beach. There is a jungle to the west.

>Unlock box
(with the Ancient Energy Staff)
You point the energy staff towards the steel box and a blue beam of energy shoots out from the tip, breaking the lock off.

>open box
It seems to be locked.

>unlock box
(with the Ancient Energy Staff)
You point the energy staff towards the steel box and a blue beam of energy shoots out from the tip, breaking the lock off.

* * *

>west
Jungle
The Jungle is dense and full of bushes, trees, and other shrubbery. Vines hang down from the dark green trees. The ground is muddy and damp. You hear loud birds squacking in the distance as a light breeze blows past you. You see an old wooden shack at the base of the largest tree. The beach is to the east.

You can see an Ancient Energy Staff here.

>inspect shack
That's not a verb I recognise.

>look at shacl
You can't see any such thing.

>look at shack
The shack is wooden and extremely weathered down. You have the feeling there is something important inside of it but the door is locked and you are unable to open it.

>look at staff
The staff is very majestic. It is made out of weathered down wood and appears to have been around for centuries. It may be old but the staff is also very heavy and sturdy. A blue energy orb is attached to the end of the staff. You have a feeling that a beam of energy can be shot from the energy orb.

>east
Beach
The sun is bright at the beach. The sand is soft but scorching hot. Crystal blue waves crash on the sand surging up and down the shoreline. You see a steel box on the beach covered in sand. There is a jungle to the west.

>look at box
A rusty mysterious box laying in the sand that is made out of steel. Maybe there is something inside. A heavy duty lock keeps it closed. You need something very powerful to break the lock and unlock the box with.

>open box with staff
You can't see any such thing.

>unlock box
(with The Steel Box)
(first taking The Steel Box)
That's hardly portable.

>unlock box with staff
You can't see any such thing.

>west
Jungle
The Jungle is dense and full of bushes, trees, and other shrubbery. Vines hang down from the dark green trees. The ground is muddy and damp. You hear loud birds squacking in the distance as a light breeze blows past you. You see an old wooden shack at the base of the largest tree.

You can see an Ancient Energy Staff here.

>take staff
Taken.

* * *

>east
Beach
The sun is bright at the beach. The sand is soft but scorching hot. Crystal blue waves crash on the sand surging up and down the shoreline. You see a steel box on the beach covered in sand. There is a jungle to the west.

>unlock box
(with the Ancient Energy Staff)
You point the energy staff towards the steel box and a blue beam of energy shoots out from the tip, breaking the lock off.

You unlock The Steel Box.

>open box
You open The Steel Box, revealing a Key.

>take key
Taken.

>west
Jungle
The Jungle is dense and full of bushes, trees, and other shrubbery. Vines hang down from the dark green trees. The ground is muddy and damp. You hear loud birds squacking in the distance as a light breeze blows past you. You see an old wooden shack at the base of the largest tree.

>look at shack
The shack is wooden and extremely weathered down. You have the feeling there is something important inside of it but the door is locked and you are unable to open it.

>unlock door
You can't see any such thing.

>unlock shack
What do you want to unlock the Wooden Shack with?

>staff
You point the staff towards the shack and a powerful beam of energy shoots out from the tip exploding the shack and everything inside of it.

    *** Your hopes of getting off of the island have been crushed. ***

Would you like to RESTART, RESTORE a saved game, QUIT or UNDO the last command?

* * *

>west
Jungle
The Jungle is dense and full of bushes, trees, and other shrubbery. Vines hang down from the dark green trees. The ground is muddy and damp. You hear loud birds squacking in the distance as a light breeze blows past you. You see an old wooden shack at the base of the largest tree. The beach is to the east.

You can see an Ancient Energy Staff here.

>inspect staff
That's not a verb I recognise.

>look at staff
The staff is very majestic. It is made out of weathered down wood and appears to be centuries old. It may be old but the staff is also very heavy and sturdy. A blue energy orb is attached to the end of the staff. You have a feeling that a beam of energy can be shot from the energy orb.

>take staff
Taken.

* * *

>east
Beach
The sun is bright at the beach. The sand is soft but scorching hot. Crystal blue waves crash on the shore surging up and down the shoreline. You see a steel box on the beach. There is a jungle to the west.

>unlock box
(with the Ancient Energy Staff)
You point the energy staff towards the steel box and a blue beam of energy shoots out from the tip, breaking the lock off. You unlock The Steel Box.

You unlock The Steel Box.

>open box
You open The Steel Box, revealing a Key.

* * *

>west
Jungle
The Jungle is dense and full of bushes, trees, and other shrubbery. Vines hang down from the dark green trees. The ground is muddy and damp. You hear loud birds squacking in the distance as a light breeze blows past you. You see an old wooden shack at the base of the largest tree.

>look at shacl
You can't see any such thing.

* * *

>look at shack
The shack is wooden and extremely weathered down. You have the feeling there is something important inside of it but the door is locked and you are unable to open it.

>open shack
It seems to be locked.

>open shack with key
You unlock the Wooden Shack.

>open shack
You open the Wooden Shack, revealing a Helicopter.

>description of helicopter
That's not a verb I recognise.

>look at helicopter
It is a very old, two-person helicopter. The GPS works. There is gas in the tank and it is ready to take-off and get you off the island. Will you take the helicopter?

>take helicopter
Taken.

    *** You win! You were able to turn on the helicopter and finally get off of the island! ***

Would you like to RESTART, RESTORE a saved game, QUIT or UNDO the last command?

* * *

>west
Jungle
The Jungle is dense and full of bushes, trees, and other shrubbery. Vines hang down from the dark green trees. The ground is muddy and damp. You hear loud birds squacking in the distance as a light breeze blows past you. You see an old wooden shack at the base of the largest tree. The beach is to the east.

You can see an Ancient Energy Staff here.

>look at staff
The staff is very majestic. It is made out of weathered down wood and appears to have been around for centuries. It may be old but the staff is also very heavy and sturdy. A blue energy orb is attached to the end of the staff. You have a feeling that a beam of energy can be shot from the energy orb.

>take staff
Taken.

* * *

>east
Beach
The sun is bright at the beach. The sand is soft but scorching hot. Crystal blue waves crash on the sand surging up and down the shoreline. You see a steel box on the beach covered in sand. There is a jungle to the west.

>look at steel box
A rusty mysterious box laying in the sand that is made out of steel. Maybe there is something inside. A heavy duty lock keeps it closed. You need something very powerful to break the lock.

>unlock box with staff
You point the energy staff towards the steel box and a blue beam of energy shoots out from the tip, breaking the lock off.

You unlock The Steel Box.

>open box
You open The Steel Box, revealing a Key.

* * *

>look at shack
The shack is wooden and extremely weathered down. You have the feeling there is something important inside of it but the door is locked and you are unable to open it.

>unlock shack
What do you want to unlock the Wooden Shack with?

>key
You unlock the Wooden Shack.

>open shack
You open the Wooden Shack, revealing a Helicopter.

>look at helicopter
It is a very old, two-person helicopter. The GPS works. There is gas in the tank and it is ready to take-off and get you off the island. Will you take the helicopter?

* * *

>west
Jungle
The Jungle is dense and full of bushes, trees, and other shrubbery. Vines hang down from the dark green trees. The ground is muddy and damp. You hear loud birds squacking in the distance as a light breeze blows past you. You see an old wooden shack at the base of the largest tree. The beach is to the east.

You can see an Ancient Energy Staff here.

>observe staff
That's not a verb I recognise.

>look at staff
The staff is very majestic. It is made out of weathered down wood and appears to be centuries old. It may be old but the staff is also very heavy and sturdy. A blue energy orb is attached to the end of the staff. You have a feeling that a beam of energy can be shot from the energy orb.

* * *

>west
Jungle
The Jungle is dense and full of bushes, trees, and other shrubbery. Vines hang down from the dark green trees. The ground is muddy and damp. You hear loud birds squacking in the distance as a light breeze blows past you. You see an old wooden shack at the base of the largest tree. The beach is to the east.

You can see an Ancient Energy Staff here.

>pick up Staff
Taken.

>east
Beach
The sun is bright at the beach. The sand is soft but scorching hot. Crystal blue waves crash on the shore surging up and down the shoreline.

>find Steel Box
That's not a verb I recognise.

>open Steel Box with Staff
You unlock The Steel Box.

>Look inside
You see nothing unexpected in that direction.

>Take The Key
I only understood you as far as wanting to take The Steel Box.

>Open Steel Box
You open The Steel Box, revealing a Key.

>Take the key
Taken.

>west
Forest
The Forest is dense and full of bushes, trees, and other shrubbery. Vines hang down from the dark green trees. The ground is muddy and damp. You hear loud birds squacking as a light breeze blows past you.

>Open Helicopter
It seems to be locked.

>Use key to open helicopter
That's not a verb I recognise.

>Use the key to open the helicopter
That's not a verb I recognise.

>east
Beach
The sun is bright at the beach. The sand is soft but scorching hot. Crystal blue waves crash on the shore surging up and down the shoreline.

>take the key
You already have that.

>west
Forest
The Forest is dense and full of bushes, trees, and other shrubbery. Vines hang down from the dark green trees. The ground is muddy and damp. You hear loud birds squacking as a light breeze blows past you.

>open The Helicopter with the key
You unlock The Helicopter.

>open Helicopter
You open The Helicopter.

* * *

>east
Beach
The sun is bright at the beach. The sand is soft but scorching hot. Crystal blue waves crash on the sand surging up and down the shoreline. You see a steel box on the beach covered in sand. There is a jungle to the west.

>open The Steel Box with The Ancient Energy Staff
You point the energy staff towards the steel box and a blue beam of energy shoots out from the tip, breaking the lock off. You unlock The Steel Box.

>open the steel box
It seems to be locked.

I beg your pardon?

>unlock the steel box
(with the Ancient Energy Staff)
You point the energy staff towards the steel box and a blue beam of energy shoots out from the tip, breaking the lock off. You unlock The Steel Box.

* * *

>east
Beach
The sun is bright at the beach. The sand is soft but scorching hot. Crystal blue waves crash on the sand surging up and down the shoreline. You see a steel box on the beach covered in sand. There is a jungle to the west.

>open box
It seems to be locked.

>open box with staff
You unlock The Steel Box.

>open box
You open The Steel Box, revealing a Key.

* * *

>east
Beach
The sun is bright at the beach. The sand is soft but scorching hot. Crystal blue waves crash on the sand surging up and down the shoreline. You see a steel box on the beach covered in sand. There is a jungle to the west.

>unlock Steel box
(with the Ancient Energy Staff)
You unlock The Steel Box.

>open box
You open The Steel Box, revealing a Key.

* * *

>take key
Taken.

>west
Forest
The Forest is dense and full of bushes, trees, and other shrubbery. Vines hang down from the dark green trees. The ground is muddy and damp. You hear loud birds squacking as a light breeze blows past you.

>unlock helicopter
What do you want to unlock The Helicopter with?

>key
You unlock The Helicopter.

I beg your pardon?

* * *

>east
Beach
The sun is bright at the beach. The sand is soft but scorching hot. Crystal blue waves crash on the sand surging up and down the shoreline. You see a steel box on the beach covered in sand. There is a jungle to the west.

>unlock box
(with the Ancient Energy Staff)
You point the energy staff towards the steel box and a blue beam of energy shoots out from the tip, breaking the lock off. You unlock The Steel Box.

>open box
It seems to be locked.

I beg your pardon?

>open the box using the staff
I only understood you as far as wanting to open The Steel Box.

I beg your pardon?

* * *

>open box
It seems to be locked.

>take key
Taken.

>open helicopter with key
You can't see any such thing.

>unlock helicopter
You can't see any such thing.

>west
Forest
The Forest is dense and full of bushes, trees, and other shrubbery. Vines hang down from the dark green trees. The ground is muddy and damp. You hear loud birds squacking as a light breeze blows past you.

* * *

>unlock box
(with the Ancient Energy Staff)
You point the energy staff towards the steel box and a blue beam of energy shoots out from the tip, breaking the lock off. You unlock The Steel Box.

>take key
You can't see any such thing.

>take The KEy
I only understood you as far as wanting to take The Steel Box.

>Open The Steel Box
It seems to be locked.

>unlock the Steel box
(with the Ancient Energy Staff)
You point the energy staff towards the steel box and a blue beam of energy shoots out from the tip, breaking the lock off. You unlock The Steel Box, revealing The Key.

>open box
It seems to be locked.

* * *

>east
Beach
The sun is bright at the beach. The sand is soft but scorching hot. Crystal blue waves crash on the sand surging up and down the shoreline. You see a steel box on the beach covered in sand. There is a jungle to the west.

>unlock box with staff
You point the energy staff towards the steel box and a blue beam of energy shoots out from the tip, breaking the lock off.

You unlock The Steel Box.

* * *

>west
Jungle
The Jungle is dense and full of bushes, trees, and other shrubbery. Vines hang down from the dark green trees. The ground is muddy and damp. You hear loud birds squacking in the distance as a light breeze blows past you. You see an old wooden shack at the base of the largest tree.

>unlock shack
What do you want to unlock the Wooden Shack with?

* * *

>east
Beach
The sun is bright at the beach. The sand is soft but scorching hot. Crystal blue waves crash on the sand surging up and down the shoreline. You see a steel box on the beach covered in sand. There is a jungle to the west.

>unlock steel box
(with the Ancient Energy Staff)
You unlock The Steel Box.

I beg your pardon?

>open steel box
You open The Steel Box, revealing a Key.

* * *

>x box
A rusty mysterious box laying in the sand that is made out of steel. Maybe there is something inside. A heavy duty lock keeps it closed. You need something very powerful to break the lock and unlock the box with.

>take box
That's hardly portable.

>w
Jungle
The Jungle is dense and full of bushes, trees, and other shrubbery. Vines hang down from the dark green trees. The ground is muddy and damp. You hear loud birds squacking in the distance as a light breeze blows past you. You see an old wooden shack at the base of the largest tree. The beach is to the east.

You can see an Ancient Energy Staff here.

>x shruberry
You can't see any such thing.

>x shubbery
You can't see any such thing.

>x shack
The shack is wooden and extremely weathered down. You have the feeling there is something important inside of it but the door is locked and you are unable to open it.

>take staff
Taken.

>x staff
The staff is very majestic. It is made out of weathered down wood and appears to have been around for centuries. It may be old but the staff is also very heavy and sturdy. A blue energy orb is attached to the end of the staff. You have a feeling that a beam of energy can be shot from the energy orb.

>shoot shack
That's not a verb I recognise.

>use staff on door
That's not a verb I recognise.

>e
Beach
The sun is bright at the beach. The sand is soft but scorching hot. Crystal blue waves crash on the sand surging up and down the shoreline. You see a steel box on the beach covered in sand. There is a jungle to the west.

>unlock lock with staff
You can't see any such thing.

>unlock box with staff
You point the energy staff towards the steel box and a blue beam of energy shoots out from the tip, breaking the lock off.

You unlock The Steel Box.

* * *

>take key
Taken.

>x key
A key that opens something in particular.

>w
Jungle
The Jungle is dense and full of bushes, trees, and other shrubbery. Vines hang down from the dark green trees. The ground is muddy and damp. You hear loud birds squacking in the distance as a light breeze blows past you. You see an old wooden shack at the base of the largest tree. The beach is to the east.

>unlock door
You can't see any such thing.

* * *

>unlock shack
What do you want to unlock the Wooden Shack with?

>unlock shack with key
You unlock the Wooden Shack.

>enter shack
That's not something you can enter.

>open shack
You open the Wooden Shack, revealing a Helicopter.

>take helicopter
Taken.

    *** You win! You were able to turn on the helicopter and finally get off of the island! ***

Would you like to RESTART, RESTORE a saved game, QUIT or UNDO the last command?

>restart
You just woke up laying in soft sand. A bright hot sun is shining in your eyes. You do not know how you ended up here but it appears as if you were washed ashore somehow. What you do know however is that you need to get off the island quickly before you go insane. You are currently on a beach.

Get Off The Island
An Interactive Fiction by ggrune20
Release 1 / Serial number 190213 / Inform 7 build 6M62 (I6/v6.33 lib 6/12N) SD

Beach
The sun is bright at the beach. The sand is soft but scorching hot. Crystal blue waves crash on the sand surging up and down the shoreline. You see a steel box on the beach covered in sand. There is a jungle to the west.

>w
Jungle
The Jungle is dense and full of bushes, trees, and other shrubbery. Vines hang down from the dark green trees. The ground is muddy and damp. You hear loud birds squacking in the distance as a light breeze blows past you. You see an old wooden shack at the base of the largest tree. The beach is to the east.

You can see an Ancient Energy Staff here.

>take staff
Taken.

>unlock shack with staff
You point the staff towards the shack and a powerful beam of energy shoots out from the tip exploding the shack and everything inside of it.

    *** You have lost. Your hopes and chance of getting off of the island have been crushed. ***

Would you like to RESTART, RESTORE a saved game, QUIT or UNDO the last command?